# 20x20 hand-built maze — small enough for step-mode viz.
20 20
S..................#
.####.######.#####.#
....#......#.#.....#
###.######.#.#.####.
#...#......#.#......
#.###.######.######.
#.....#......#......
#.#####.######.####.
#.#.....#......#....
#.#.#####.######.###
#.#.#......#........
#.#.#.######.######.
#.#.#.#......#......
#.#.#.#.######.####.
#.#.#.#.#......#....
#.#.#.#.#.######.###
#.#.#.#.#.#.........
#.#.#.#.#.#.#######.
..#.#.#.#.#.........
..#...#...#........E
